00 00
01 00 00 01 00 01 00 01
01 00 00 01 00 01 00 01
10 00 10 00 10 00 10 00 
70 00 70 00 70 00 70 00 
01 00 00 01 00 01 00 01
01 00 00 01 00 01 00 01
01 01 01 01 01 01 01 01
02 02 02 02 02 02 02

01 00 00 01 00 01 00 01
01 00 00 01 00 01 00 01
11 00 11 00 11 00 11 00 
71 00 71 00 71 00 71 00 
01 00 00 01 00 01 00 01
01 00 00 01 00 01 00 01
01 01 01 01 01 01 01 01
02 02 02 02 02 02 02 02